111111111111111111111111111111111111
1P000000001C000011111000000001111111
100000000000011111111111111111000E11
111111110C00000000000000C11100001111
11111C00000C00000011111000C000111111
111111111111111111111111111111111111