111111111111111111
1P110C000C00111011
100000100001100011
1E0001C00000111111
1C1110000000000001
1011110000000000C1
100000C000001C1111
1000C1C00000111101
111111111111111111