1111111111111
1010000000101
1111111111111
10101100001C1
101001P00CE01
1111111111111