1111111111111111111111111
1P000000C000000C000000001
101C1101011C010011100C101
1011C01010111011C01111001
1E0000000C00C000000000001
101111110C011111C00111001
1000C00111000C111000000C1
11100000CC00000000011C111
1111111111111111111111111
