1111111111111111111111
1E1000000C00000C000001
1010010100100000101001
101001001010101C001001
1P0000000C00C0000000C1
1111111111111111111111
