1111111111111111111111111111111111
10111111111111111111111111111111C1
1E1111111111110C01100C111000C00001
101111010010000010100111C000010101
1010010010101010001000000000001011
1P00C0010C00C0000000001111110000C1
1011111111111111C11111111111111111
1000000C000000C0000C00000C00000C11
1011111111111111111111111111111101
1111111111111111111111111111111111
